"filename", "language", "CSS", "JavaScript", "JavaScript JSX", "comment", "blank", "total"
"c:\Users\pa515\Downloads\wran-bulkProjectModified-main\wran-bulkProjectModified-main\src\App.jsx", "JavaScript JSX", 0, 0, 21, 72, 1, 94
"c:\Users\pa515\Downloads\wran-bulkProjectModified-main\wran-bulkProjectModified-main\src\components\Alerts\Alerts.jsx", "JavaScript JSX", 0, 0, 48, 4, 7, 59
"c:\Users\pa515\Downloads\wran-bulkProjectModified-main\wran-bulkProjectModified-main\src\components\Alerts\Alerts.stories.js", "JavaScript", 0, 13, 0, 0, 3, 16
"c:\Users\pa515\Downloads\wran-bulkProjectModified-main\wran-bulkProjectModified-main\src\components\Alerts\index.js", "JavaScript", 0, 1, 0, 0, 1, 2
"c:\Users\pa515\Downloads\wran-bulkProjectModified-main\wran-bulkProjectModified-main\src\components\Alerts\style.css", "CSS", 105, 0, 0, 0, 19, 124
"c:\Users\pa515\Downloads\wran-bulkProjectModified-main\wran-bulkProjectModified-main\src\components\AtomsIconWrapper\AtomsIconWrapper.jsx", "JavaScript JSX", 0, 0, 9, 4, 3, 16
"c:\Users\pa515\Downloads\wran-bulkProjectModified-main\wran-bulkProjectModified-main\src\components\AtomsIconWrapper\AtomsIconWrapper.stories.js", "JavaScript", 0, 11, 0, 0, 3, 14
"c:\Users\pa515\Downloads\wran-bulkProjectModified-main\wran-bulkProjectModified-main\src\components\AtomsIconWrapper\index.js", "JavaScript", 0, 1, 0, 0, 1, 2
"c:\Users\pa515\Downloads\wran-bulkProjectModified-main\wran-bulkProjectModified-main\src\components\AtomsIconWrapper\style.css", "CSS", 10, 0, 0, 0, 2, 12
"c:\Users\pa515\Downloads\wran-bulkProjectModified-main\wran-bulkProjectModified-main\src\components\AtomsIcon\AtomsIcon.jsx", "JavaScript JSX", 0, 0, 18, 4, 3, 25
"c:\Users\pa515\Downloads\wran-bulkProjectModified-main\wran-bulkProjectModified-main\src\components\AtomsIcon\AtomsIcon.stories.js", "JavaScript", 0, 10, 0, 0, 3, 13
"c:\Users\pa515\Downloads\wran-bulkProjectModified-main\wran-bulkProjectModified-main\src\components\AtomsIcon\index.js", "JavaScript", 0, 1, 0, 0, 1, 2
"c:\Users\pa515\Downloads\wran-bulkProjectModified-main\wran-bulkProjectModified-main\src\components\AtomsIcon\style.css", "CSS", 32, 0, 0, 0, 6, 38
"c:\Users\pa515\Downloads\wran-bulkProjectModified-main\wran-bulkProjectModified-main\src\components\Bar\Bar.jsx", "JavaScript JSX", 0, 0, 9, 4, 4, 17
"c:\Users\pa515\Downloads\wran-bulkProjectModified-main\wran-bulkProjectModified-main\src\components\Bar\Bar.stories.js", "JavaScript", 0, 11, 0, 0, 3, 14
"c:\Users\pa515\Downloads\wran-bulkProjectModified-main\wran-bulkProjectModified-main\src\components\Bar\index.js", "JavaScript", 0, 1, 0, 0, 1, 2
"c:\Users\pa515\Downloads\wran-bulkProjectModified-main\wran-bulkProjectModified-main\src\components\Bar\style.css", "CSS", 10, 0, 0, 0, 3, 13
"c:\Users\pa515\Downloads\wran-bulkProjectModified-main\wran-bulkProjectModified-main\src\components\Divider\Divider.jsx", "JavaScript JSX", 0, 0, 9, 4, 4, 17
"c:\Users\pa515\Downloads\wran-bulkProjectModified-main\wran-bulkProjectModified-main\src\components\Divider\Divider.stories.js", "JavaScript", 0, 11, 0, 0, 3, 14
"c:\Users\pa515\Downloads\wran-bulkProjectModified-main\wran-bulkProjectModified-main\src\components\Divider\index.js", "JavaScript", 0, 1, 0, 0, 1, 2
"c:\Users\pa515\Downloads\wran-bulkProjectModified-main\wran-bulkProjectModified-main\src\components\Divider\style.css", "CSS", 31, 0, 0, 0, 5, 36
"c:\Users\pa515\Downloads\wran-bulkProjectModified-main\wran-bulkProjectModified-main\src\components\GlobalHeader\GlobalHeader.jsx", "JavaScript JSX", 0, 0, 160, 4, 9, 173
"c:\Users\pa515\Downloads\wran-bulkProjectModified-main\wran-bulkProjectModified-main\src\components\GlobalHeader\GlobalHeader.stories.js", "JavaScript", 0, 25, 0, 0, 3, 28
"c:\Users\pa515\Downloads\wran-bulkProjectModified-main\wran-bulkProjectModified-main\src\components\GlobalHeader\index.js", "JavaScript", 0, 1, 0, 0, 1, 2
"c:\Users\pa515\Downloads\wran-bulkProjectModified-main\wran-bulkProjectModified-main\src\components\GlobalHeader\style.css", "CSS", 219, 0, 0, 0, 37, 256
"c:\Users\pa515\Downloads\wran-bulkProjectModified-main\wran-bulkProjectModified-main\src\components\IconClose\IconClose.jsx", "JavaScript JSX", 0, 0, 6, 4, 3, 13
"c:\Users\pa515\Downloads\wran-bulkProjectModified-main\wran-bulkProjectModified-main\src\components\IconClose\IconClose.stories.js", "JavaScript", 0, 8, 0, 0, 3, 11
"c:\Users\pa515\Downloads\wran-bulkProjectModified-main\wran-bulkProjectModified-main\src\components\IconClose\index.js", "JavaScript", 0, 1, 0, 0, 1, 2
"c:\Users\pa515\Downloads\wran-bulkProjectModified-main\wran-bulkProjectModified-main\src\components\IconClose\style.css", "CSS", 7, 0, 0, 0, 1, 8
"c:\Users\pa515\Downloads\wran-bulkProjectModified-main\wran-bulkProjectModified-main\src\components\IconSearchWrapper\IconSearchWrapper.jsx", "JavaScript JSX", 0, 0, 6, 4, 3, 13
"c:\Users\pa515\Downloads\wran-bulkProjectModified-main\wran-bulkProjectModified-main\src\components\IconSearchWrapper\IconSearchWrapper.stories.js", "JavaScript", 0, 8, 0, 0, 3, 11
"c:\Users\pa515\Downloads\wran-bulkProjectModified-main\wran-bulkProjectModified-main\src\components\IconSearchWrapper\index.js", "JavaScript", 0, 1, 0, 0, 1, 2
"c:\Users\pa515\Downloads\wran-bulkProjectModified-main\wran-bulkProjectModified-main\src\components\IconSearchWrapper\style.css", "CSS", 7, 0, 0, 0, 1, 8
"c:\Users\pa515\Downloads\wran-bulkProjectModified-main\wran-bulkProjectModified-main\src\components\LinkWidget\LinkWidget.jsx", "JavaScript JSX", 0, 0, 204, 4, 4, 212
"c:\Users\pa515\Downloads\wran-bulkProjectModified-main\wran-bulkProjectModified-main\src\components\LinkWidget\LinkWidget.stories.js", "JavaScript", 0, 30, 0, 0, 3, 33
"c:\Users\pa515\Downloads\wran-bulkProjectModified-main\wran-bulkProjectModified-main\src\components\LinkWidget\index.js", "JavaScript", 0, 1, 0, 0, 1, 2
"c:\Users\pa515\Downloads\wran-bulkProjectModified-main\wran-bulkProjectModified-main\src\components\LinkWidget\style.css", "CSS", 89, 0, 0, 0, 13, 102
"c:\Users\pa515\Downloads\wran-bulkProjectModified-main\wran-bulkProjectModified-main\src\components\LogoCanvaslogo\LogoCanvaslogo.jsx", "JavaScript JSX", 0, 0, 27, 4, 3, 34
"c:\Users\pa515\Downloads\wran-bulkProjectModified-main\wran-bulkProjectModified-main\src\components\LogoCanvaslogo\LogoCanvaslogo.stories.js", "JavaScript", 0, 11, 0, 0, 3, 14
"c:\Users\pa515\Downloads\wran-bulkProjectModified-main\wran-bulkProjectModified-main\src\components\LogoCanvaslogo\index.js", "JavaScript", 0, 1, 0, 0, 1, 2
"c:\Users\pa515\Downloads\wran-bulkProjectModified-main\wran-bulkProjectModified-main\src\components\LogoCanvaslogo\style.css", "CSS", 71, 0, 0, 0, 11, 82
"c:\Users\pa515\Downloads\wran-bulkProjectModified-main\wran-bulkProjectModified-main\src\components\Scrollbar\Scrollbar.jsx", "JavaScript JSX", 0, 0, 13, 4, 4, 21
"c:\Users\pa515\Downloads\wran-bulkProjectModified-main\wran-bulkProjectModified-main\src\components\Scrollbar\Scrollbar.stories.js", "JavaScript", 0, 11, 0, 0, 3, 14
"c:\Users\pa515\Downloads\wran-bulkProjectModified-main\wran-bulkProjectModified-main\src\components\Scrollbar\index.js", "JavaScript", 0, 1, 0, 0, 1, 2
"c:\Users\pa515\Downloads\wran-bulkProjectModified-main\wran-bulkProjectModified-main\src\components\Scrollbar\style.css", "CSS", 28, 0, 0, 0, 5, 33
"c:\Users\pa515\Downloads\wran-bulkProjectModified-main\wran-bulkProjectModified-main\src\components\SearchInput\SearchInput.jsx", "JavaScript JSX", 0, 0, 53, 4, 6, 63
"c:\Users\pa515\Downloads\wran-bulkProjectModified-main\wran-bulkProjectModified-main\src\components\SearchInput\SearchInput.stories.js", "JavaScript", 0, 14, 0, 0, 3, 17
"c:\Users\pa515\Downloads\wran-bulkProjectModified-main\wran-bulkProjectModified-main\src\components\SearchInput\index.js", "JavaScript", 0, 1, 0, 0, 1, 2
"c:\Users\pa515\Downloads\wran-bulkProjectModified-main\wran-bulkProjectModified-main\src\components\SearchInput\style.css", "CSS", 178, 0, 0, 0, 27, 205
"c:\Users\pa515\Downloads\wran-bulkProjectModified-main\wran-bulkProjectModified-main\src\components\TabItems\TabItems.jsx", "JavaScript JSX", 0, 0, 47, 4, 8, 59
"c:\Users\pa515\Downloads\wran-bulkProjectModified-main\wran-bulkProjectModified-main\src\components\TabItems\TabItems.stories.js", "JavaScript", 0, 16, 0, 0, 3, 19
"c:\Users\pa515\Downloads\wran-bulkProjectModified-main\wran-bulkProjectModified-main\src\components\TabItems\index.js", "JavaScript", 0, 1, 0, 0, 1, 2
"c:\Users\pa515\Downloads\wran-bulkProjectModified-main\wran-bulkProjectModified-main\src\components\TabItems\style.css", "CSS", 174, 0, 0, 0, 29, 203
"c:\Users\pa515\Downloads\wran-bulkProjectModified-main\wran-bulkProjectModified-main\src\components\Tab\Tab.jsx", "JavaScript JSX", 0, 0, 117, 4, 9, 130
"c:\Users\pa515\Downloads\wran-bulkProjectModified-main\wran-bulkProjectModified-main\src\components\Tab\Tab.stories.js", "JavaScript", 0, 37, 0, 0, 3, 40
"c:\Users\pa515\Downloads\wran-bulkProjectModified-main\wran-bulkProjectModified-main\src\components\Tab\index.js", "JavaScript", 0, 1, 0, 0, 1, 2
"c:\Users\pa515\Downloads\wran-bulkProjectModified-main\wran-bulkProjectModified-main\src\components\Tab\style.css", "CSS", 7, 0, 0, 0, 1, 8
"c:\Users\pa515\Downloads\wran-bulkProjectModified-main\wran-bulkProjectModified-main\src\components\TreeMenu\TreeMenu.jsx", "JavaScript JSX", 0, 0, 92, 4, 15, 111
"c:\Users\pa515\Downloads\wran-bulkProjectModified-main\wran-bulkProjectModified-main\src\components\TreeMenu\TreeMenu.stories.js", "JavaScript", 0, 20, 0, 0, 3, 23
"c:\Users\pa515\Downloads\wran-bulkProjectModified-main\wran-bulkProjectModified-main\src\components\TreeMenu\index.js", "JavaScript", 0, 1, 0, 0, 1, 2
"c:\Users\pa515\Downloads\wran-bulkProjectModified-main\wran-bulkProjectModified-main\src\components\TreeMenu\style.css", "CSS", 218, 0, 0, 0, 39, 257
"c:\Users\pa515\Downloads\wran-bulkProjectModified-main\wran-bulkProjectModified-main\src\icons\AtomsIcon2019Close2\AtomsIcon2019Close2.jsx", "JavaScript JSX", 0, 0, 21, 4, 3, 28
"c:\Users\pa515\Downloads\wran-bulkProjectModified-main\wran-bulkProjectModified-main\src\icons\AtomsIcon2019Close2\index.js", "JavaScript", 0, 1, 0, 0, 1, 2
"c:\Users\pa515\Downloads\wran-bulkProjectModified-main\wran-bulkProjectModified-main\src\icons\AtomsIcon2019Close4\AtomsIcon2019Close4.jsx", "JavaScript JSX", 0, 0, 21, 4, 3, 28
"c:\Users\pa515\Downloads\wran-bulkProjectModified-main\wran-bulkProjectModified-main\src\icons\AtomsIcon2019Close4\index.js", "JavaScript", 0, 1, 0, 0, 1, 2
"c:\Users\pa515\Downloads\wran-bulkProjectModified-main\wran-bulkProjectModified-main\src\icons\AtomsIcon2019Close578\AtomsIcon2019Close578.jsx", "JavaScript JSX", 0, 0, 24, 4, 3, 31
"c:\Users\pa515\Downloads\wran-bulkProjectModified-main\wran-bulkProjectModified-main\src\icons\AtomsIcon2019Close578\index.js", "JavaScript", 0, 1, 0, 0, 1, 2
"c:\Users\pa515\Downloads\wran-bulkProjectModified-main\wran-bulkProjectModified-main\src\icons\AtomsIcon2019Close579\AtomsIcon2019Close579.jsx", "JavaScript JSX", 0, 0, 24, 4, 3, 31
"c:\Users\pa515\Downloads\wran-bulkProjectModified-main\wran-bulkProjectModified-main\src\icons\AtomsIcon2019Close579\index.js", "JavaScript", 0, 1, 0, 0, 1, 2
"c:\Users\pa515\Downloads\wran-bulkProjectModified-main\wran-bulkProjectModified-main\src\icons\AtomsIcon2019Close62\AtomsIcon2019Close62.jsx", "JavaScript JSX", 0, 0, 31, 4, 3, 38
"c:\Users\pa515\Downloads\wran-bulkProjectModified-main\wran-bulkProjectModified-main\src\icons\AtomsIcon2019Close62\index.js", "JavaScript", 0, 1, 0, 0, 1, 2
"c:\Users\pa515\Downloads\wran-bulkProjectModified-main\wran-bulkProjectModified-main\src\icons\AtomsIcon2019Close68\AtomsIcon2019Close68.jsx", "JavaScript JSX", 0, 0, 19, 4, 3, 26
"c:\Users\pa515\Downloads\wran-bulkProjectModified-main\wran-bulkProjectModified-main\src\icons\AtomsIcon2019Close68\index.js", "JavaScript", 0, 1, 0, 0, 1, 2
"c:\Users\pa515\Downloads\wran-bulkProjectModified-main\wran-bulkProjectModified-main\src\icons\AtomsIcon2019Close702\AtomsIcon2019Close702.jsx", "JavaScript JSX", 0, 0, 19, 4, 3, 26
"c:\Users\pa515\Downloads\wran-bulkProjectModified-main\wran-bulkProjectModified-main\src\icons\AtomsIcon2019Close702\index.js", "JavaScript", 0, 1, 0, 0, 1, 2
"c:\Users\pa515\Downloads\wran-bulkProjectModified-main\wran-bulkProjectModified-main\src\icons\AtomsIcon2019Close71\AtomsIcon2019Close71.jsx", "JavaScript JSX", 0, 0, 19, 4, 3, 26
"c:\Users\pa515\Downloads\wran-bulkProjectModified-main\wran-bulkProjectModified-main\src\icons\AtomsIcon2019Close71\index.js", "JavaScript", 0, 1, 0, 0, 1, 2
"c:\Users\pa515\Downloads\wran-bulkProjectModified-main\wran-bulkProjectModified-main\src\icons\AtomsIcon2019Close94\AtomsIcon2019Close94.jsx", "JavaScript JSX", 0, 0, 23, 4, 4, 31
"c:\Users\pa515\Downloads\wran-bulkProjectModified-main\wran-bulkProjectModified-main\src\icons\AtomsIcon2019Close94\index.js", "JavaScript", 0, 1, 0, 0, 1, 2
"c:\Users\pa515\Downloads\wran-bulkProjectModified-main\wran-bulkProjectModified-main\src\icons\AtomsIcon2019Menu1\AtomsIcon2019Menu1.jsx", "JavaScript JSX", 0, 0, 17, 4, 3, 24
"c:\Users\pa515\Downloads\wran-bulkProjectModified-main\wran-bulkProjectModified-main\src\icons\AtomsIcon2019Menu1\index.js", "JavaScript", 0, 1, 0, 0, 1, 2
"c:\Users\pa515\Downloads\wran-bulkProjectModified-main\wran-bulkProjectModified-main\src\icons\Checkbox1\Checkbox1.jsx", "JavaScript JSX", 0, 0, 21, 4, 3, 28
"c:\Users\pa515\Downloads\wran-bulkProjectModified-main\wran-bulkProjectModified-main\src\icons\Checkbox1\index.js", "JavaScript", 0, 1, 0, 0, 1, 2
"c:\Users\pa515\Downloads\wran-bulkProjectModified-main\wran-bulkProjectModified-main\src\icons\Checkbox\Checkbox.jsx", "JavaScript JSX", 0, 0, 26, 4, 4, 34
"c:\Users\pa515\Downloads\wran-bulkProjectModified-main\wran-bulkProjectModified-main\src\icons\Checkbox\index.js", "JavaScript", 0, 1, 0, 0, 1, 2
"c:\Users\pa515\Downloads\wran-bulkProjectModified-main\wran-bulkProjectModified-main\src\icons\Click2\Click2.jsx", "JavaScript JSX", 0, 0, 91, 4, 3, 98
"c:\Users\pa515\Downloads\wran-bulkProjectModified-main\wran-bulkProjectModified-main\src\icons\Click2\index.js", "JavaScript", 0, 1, 0, 0, 1, 2
"c:\Users\pa515\Downloads\wran-bulkProjectModified-main\wran-bulkProjectModified-main\src\icons\Click3\Click3.jsx", "JavaScript JSX", 0, 0, 91, 4, 3, 98
"c:\Users\pa515\Downloads\wran-bulkProjectModified-main\wran-bulkProjectModified-main\src\icons\Click3\index.js", "JavaScript", 0, 1, 0, 0, 1, 2
"c:\Users\pa515\Downloads\wran-bulkProjectModified-main\wran-bulkProjectModified-main\src\icons\Click4\Click4.jsx", "JavaScript JSX", 0, 0, 91, 4, 3, 98
"c:\Users\pa515\Downloads\wran-bulkProjectModified-main\wran-bulkProjectModified-main\src\icons\Click4\index.js", "JavaScript", 0, 1, 0, 0, 1, 2
"c:\Users\pa515\Downloads\wran-bulkProjectModified-main\wran-bulkProjectModified-main\src\icons\Click5\Click5.jsx", "JavaScript JSX", 0, 0, 91, 4, 3, 98
"c:\Users\pa515\Downloads\wran-bulkProjectModified-main\wran-bulkProjectModified-main\src\icons\Click5\index.js", "JavaScript", 0, 1, 0, 0, 1, 2
"c:\Users\pa515\Downloads\wran-bulkProjectModified-main\wran-bulkProjectModified-main\src\icons\Click6\Click6.jsx", "JavaScript JSX", 0, 0, 91, 4, 3, 98
"c:\Users\pa515\Downloads\wran-bulkProjectModified-main\wran-bulkProjectModified-main\src\icons\Click6\index.js", "JavaScript", 0, 1, 0, 0, 1, 2
"c:\Users\pa515\Downloads\wran-bulkProjectModified-main\wran-bulkProjectModified-main\src\icons\Click7\Click7.jsx", "JavaScript JSX", 0, 0, 91, 4, 3, 98
"c:\Users\pa515\Downloads\wran-bulkProjectModified-main\wran-bulkProjectModified-main\src\icons\Click7\index.js", "JavaScript", 0, 1, 0, 0, 1, 2
"c:\Users\pa515\Downloads\wran-bulkProjectModified-main\wran-bulkProjectModified-main\src\icons\Click8\Click8.jsx", "JavaScript JSX", 0, 0, 91, 4, 3, 98
"c:\Users\pa515\Downloads\wran-bulkProjectModified-main\wran-bulkProjectModified-main\src\icons\Click8\index.js", "JavaScript", 0, 1, 0, 0, 1, 2
"c:\Users\pa515\Downloads\wran-bulkProjectModified-main\wran-bulkProjectModified-main\src\icons\Click9\Click9.jsx", "JavaScript JSX", 0, 0, 91, 4, 3, 98
"c:\Users\pa515\Downloads\wran-bulkProjectModified-main\wran-bulkProjectModified-main\src\icons\Click9\index.js", "JavaScript", 0, 1, 0, 0, 1, 2
"c:\Users\pa515\Downloads\wran-bulkProjectModified-main\wran-bulkProjectModified-main\src\icons\Click\Click.jsx", "JavaScript JSX", 0, 0, 91, 4, 3, 98
"c:\Users\pa515\Downloads\wran-bulkProjectModified-main\wran-bulkProjectModified-main\src\icons\Click\index.js", "JavaScript", 0, 1, 0, 0, 1, 2
"c:\Users\pa515\Downloads\wran-bulkProjectModified-main\wran-bulkProjectModified-main\src\icons\CombinedShape1\CombinedShape1.jsx", "JavaScript JSX", 0, 0, 21, 4, 3, 28
"c:\Users\pa515\Downloads\wran-bulkProjectModified-main\wran-bulkProjectModified-main\src\icons\CombinedShape1\index.js", "JavaScript", 0, 1, 0, 0, 1, 2
"c:\Users\pa515\Downloads\wran-bulkProjectModified-main\wran-bulkProjectModified-main\src\icons\CombinedShape\CombinedShape.jsx", "JavaScript JSX", 0, 0, 21, 4, 3, 28
"c:\Users\pa515\Downloads\wran-bulkProjectModified-main\wran-bulkProjectModified-main\src\icons\CombinedShape\index.js", "JavaScript", 0, 1, 0, 0, 1, 2
"c:\Users\pa515\Downloads\wran-bulkProjectModified-main\wran-bulkProjectModified-main\src\icons\Icon3\Icon3.jsx", "JavaScript JSX", 0, 0, 15, 4, 3, 22
"c:\Users\pa515\Downloads\wran-bulkProjectModified-main\wran-bulkProjectModified-main\src\icons\Icon3\index.js", "JavaScript", 0, 1, 0, 0, 1, 2
"c:\Users\pa515\Downloads\wran-bulkProjectModified-main\wran-bulkProjectModified-main\src\icons\IconCheckmarkAlt\IconCheckmarkAlt.jsx", "JavaScript JSX", 0, 0, 26, 4, 3, 33
"c:\Users\pa515\Downloads\wran-bulkProjectModified-main\wran-bulkProjectModified-main\src\icons\IconCheckmarkAlt\index.js", "JavaScript", 0, 1, 0, 0, 1, 2
"c:\Users\pa515\Downloads\wran-bulkProjectModified-main\wran-bulkProjectModified-main\src\icons\IconClose50\IconClose50.jsx", "JavaScript JSX", 0, 0, 19, 4, 3, 26
"c:\Users\pa515\Downloads\wran-bulkProjectModified-main\wran-bulkProjectModified-main\src\icons\IconClose50\index.js", "JavaScript", 0, 1, 0, 0, 1, 2
"c:\Users\pa515\Downloads\wran-bulkProjectModified-main\wran-bulkProjectModified-main\src\icons\IconCtaCaretClose19\IconCtaCaretClose19.jsx", "JavaScript JSX", 0, 0, 19, 4, 3, 26
"c:\Users\pa515\Downloads\wran-bulkProjectModified-main\wran-bulkProjectModified-main\src\icons\IconCtaCaretClose19\index.js", "JavaScript", 0, 1, 0, 0, 1, 2
"c:\Users\pa515\Downloads\wran-bulkProjectModified-main\wran-bulkProjectModified-main\src\icons\IconCtaCaretClose27\IconCtaCaretClose27.jsx", "JavaScript JSX", 0, 0, 19, 4, 3, 26
"c:\Users\pa515\Downloads\wran-bulkProjectModified-main\wran-bulkProjectModified-main\src\icons\IconCtaCaretClose27\index.js", "JavaScript", 0, 1, 0, 0, 1, 2
"c:\Users\pa515\Downloads\wran-bulkProjectModified-main\wran-bulkProjectModified-main\src\icons\IconCtaCaretOpen\IconCtaCaretOpen.jsx", "JavaScript JSX", 0, 0, 19, 4, 3, 26
"c:\Users\pa515\Downloads\wran-bulkProjectModified-main\wran-bulkProjectModified-main\src\icons\IconCtaCaretOpen\index.js", "JavaScript", 0, 1, 0, 0, 1, 2
"c:\Users\pa515\Downloads\wran-bulkProjectModified-main\wran-bulkProjectModified-main\src\icons\IconDownload\IconDownload.jsx", "JavaScript JSX", 0, 0, 20, 4, 3, 27
"c:\Users\pa515\Downloads\wran-bulkProjectModified-main\wran-bulkProjectModified-main\src\icons\IconDownload\index.js", "JavaScript", 0, 1, 0, 0, 1, 2
"c:\Users\pa515\Downloads\wran-bulkProjectModified-main\wran-bulkProjectModified-main\src\icons\IconExport\IconExport.jsx", "JavaScript JSX", 0, 0, 24, 4, 3, 31
"c:\Users\pa515\Downloads\wran-bulkProjectModified-main\wran-bulkProjectModified-main\src\icons\IconExport\index.js", "JavaScript", 0, 1, 0, 0, 1, 2
"c:\Users\pa515\Downloads\wran-bulkProjectModified-main\wran-bulkProjectModified-main\src\icons\IconFilledCursor1\IconFilledCursor1.jsx", "JavaScript JSX", 0, 0, 65, 4, 3, 72
"c:\Users\pa515\Downloads\wran-bulkProjectModified-main\wran-bulkProjectModified-main\src\icons\IconFilledCursor1\index.js", "JavaScript", 0, 1, 0, 0, 1, 2
"c:\Users\pa515\Downloads\wran-bulkProjectModified-main\wran-bulkProjectModified-main\src\icons\IconFilterClear\IconFilterClear.jsx", "JavaScript JSX", 0, 0, 26, 4, 3, 33
"c:\Users\pa515\Downloads\wran-bulkProjectModified-main\wran-bulkProjectModified-main\src\icons\IconFilterClear\index.js", "JavaScript", 0, 1, 0, 0, 1, 2
"c:\Users\pa515\Downloads\wran-bulkProjectModified-main\wran-bulkProjectModified-main\src\icons\IconFilterOff\IconFilterOff.jsx", "JavaScript JSX", 0, 0, 26, 4, 3, 33
"c:\Users\pa515\Downloads\wran-bulkProjectModified-main\wran-bulkProjectModified-main\src\icons\IconFilterOff\index.js", "JavaScript", 0, 1, 0, 0, 1, 2
"c:\Users\pa515\Downloads\wran-bulkProjectModified-main\wran-bulkProjectModified-main\src\icons\IconFilter\IconFilter.jsx", "JavaScript JSX", 0, 0, 21, 4, 3, 28
"c:\Users\pa515\Downloads\wran-bulkProjectModified-main\wran-bulkProjectModified-main\src\icons\IconFilter\index.js", "JavaScript", 0, 1, 0, 0, 1, 2
"c:\Users\pa515\Downloads\wran-bulkProjectModified-main\wran-bulkProjectModified-main\src\icons\IconInfo3\IconInfo3.jsx", "JavaScript JSX", 0, 0, 23, 4, 3, 30
"c:\Users\pa515\Downloads\wran-bulkProjectModified-main\wran-bulkProjectModified-main\src\icons\IconInfo3\index.js", "JavaScript", 0, 1, 0, 0, 1, 2
"c:\Users\pa515\Downloads\wran-bulkProjectModified-main\wran-bulkProjectModified-main\src\icons\IconInfo\IconInfo.jsx", "JavaScript JSX", 0, 0, 23, 4, 3, 30
"c:\Users\pa515\Downloads\wran-bulkProjectModified-main\wran-bulkProjectModified-main\src\icons\IconInfo\index.js", "JavaScript", 0, 1, 0, 0, 1, 2
"c:\Users\pa515\Downloads\wran-bulkProjectModified-main\wran-bulkProjectModified-main\src\icons\IconMinusLarge\IconMinusLarge.jsx", "JavaScript JSX", 0, 0, 15, 4, 3, 22
"c:\Users\pa515\Downloads\wran-bulkProjectModified-main\wran-bulkProjectModified-main\src\icons\IconMinusLarge\index.js", "JavaScript", 0, 1, 0, 0, 1, 2
"c:\Users\pa515\Downloads\wran-bulkProjectModified-main\wran-bulkProjectModified-main\src\icons\IconPlusLarge3\IconPlusLarge3.jsx", "JavaScript JSX", 0, 0, 19, 4, 3, 26
"c:\Users\pa515\Downloads\wran-bulkProjectModified-main\wran-bulkProjectModified-main\src\icons\IconPlusLarge3\index.js", "JavaScript", 0, 1, 0, 0, 1, 2
"c:\Users\pa515\Downloads\wran-bulkProjectModified-main\wran-bulkProjectModified-main\src\icons\IconPlusSmall\IconPlusSmall.jsx", "JavaScript JSX", 0, 0, 15, 4, 3, 22
"c:\Users\pa515\Downloads\wran-bulkProjectModified-main\wran-bulkProjectModified-main\src\icons\IconPlusSmall\index.js", "JavaScript", 0, 1, 0, 0, 1, 2
"c:\Users\pa515\Downloads\wran-bulkProjectModified-main\wran-bulkProjectModified-main\src\icons\IconSaveFloppy\IconSaveFloppy.jsx", "JavaScript JSX", 0, 0, 27, 4, 3, 34
"c:\Users\pa515\Downloads\wran-bulkProjectModified-main\wran-bulkProjectModified-main\src\icons\IconSaveFloppy\index.js", "JavaScript", 0, 1, 0, 0, 1, 2
"c:\Users\pa515\Downloads\wran-bulkProjectModified-main\wran-bulkProjectModified-main\src\icons\IconSearch\IconSearch.jsx", "JavaScript JSX", 0, 0, 21, 4, 3, 28
"c:\Users\pa515\Downloads\wran-bulkProjectModified-main\wran-bulkProjectModified-main\src\icons\IconSearch\index.js", "JavaScript", 0, 1, 0, 0, 1, 2
"c:\Users\pa515\Downloads\wran-bulkProjectModified-main\wran-bulkProjectModified-main\src\icons\IconUpload\IconUpload.jsx", "JavaScript JSX", 0, 0, 20, 4, 3, 27
"c:\Users\pa515\Downloads\wran-bulkProjectModified-main\wran-bulkProjectModified-main\src\icons\IconUpload\index.js", "JavaScript", 0, 1, 0, 0, 1, 2
"c:\Users\pa515\Downloads\wran-bulkProjectModified-main\wran-bulkProjectModified-main\src\icons\Line\Line.jsx", "JavaScript JSX", 0, 0, 25, 4, 3, 32
"c:\Users\pa515\Downloads\wran-bulkProjectModified-main\wran-bulkProjectModified-main\src\icons\Line\index.js", "JavaScript", 0, 1, 0, 0, 1, 2
"c:\Users\pa515\Downloads\wran-bulkProjectModified-main\wran-bulkProjectModified-main\src\icons\Path13\Path13.jsx", "JavaScript JSX", 0, 0, 19, 4, 3, 26
"c:\Users\pa515\Downloads\wran-bulkProjectModified-main\wran-bulkProjectModified-main\src\icons\Path13\index.js", "JavaScript", 0, 1, 0, 0, 1, 2
"c:\Users\pa515\Downloads\wran-bulkProjectModified-main\wran-bulkProjectModified-main\src\icons\Path28\Path28.jsx", "JavaScript JSX", 0, 0, 19, 4, 3, 26
"c:\Users\pa515\Downloads\wran-bulkProjectModified-main\wran-bulkProjectModified-main\src\icons\Path28\index.js", "JavaScript", 0, 1, 0, 0, 1, 2
"c:\Users\pa515\Downloads\wran-bulkProjectModified-main\wran-bulkProjectModified-main\src\icons\Path29\Path29.jsx", "JavaScript JSX", 0, 0, 19, 4, 3, 26
"c:\Users\pa515\Downloads\wran-bulkProjectModified-main\wran-bulkProjectModified-main\src\icons\Path29\index.js", "JavaScript", 0, 1, 0, 0, 1, 2
"c:\Users\pa515\Downloads\wran-bulkProjectModified-main\wran-bulkProjectModified-main\src\icons\Path38\Path38.jsx", "JavaScript JSX", 0, 0, 19, 4, 3, 26
"c:\Users\pa515\Downloads\wran-bulkProjectModified-main\wran-bulkProjectModified-main\src\icons\Path38\index.js", "JavaScript", 0, 1, 0, 0, 1, 2
"c:\Users\pa515\Downloads\wran-bulkProjectModified-main\wran-bulkProjectModified-main\src\icons\Path414\Path414.jsx", "JavaScript JSX", 0, 0, 19, 4, 3, 26
"c:\Users\pa515\Downloads\wran-bulkProjectModified-main\wran-bulkProjectModified-main\src\icons\Path414\index.js", "JavaScript", 0, 1, 0, 0, 1, 2
"c:\Users\pa515\Downloads\wran-bulkProjectModified-main\wran-bulkProjectModified-main\src\icons\Path415\Path415.jsx", "JavaScript JSX", 0, 0, 19, 4, 3, 26
"c:\Users\pa515\Downloads\wran-bulkProjectModified-main\wran-bulkProjectModified-main\src\icons\Path415\index.js", "JavaScript", 0, 1, 0, 0, 1, 2
"c:\Users\pa515\Downloads\wran-bulkProjectModified-main\wran-bulkProjectModified-main\src\icons\Path5\Path5.jsx", "JavaScript JSX", 0, 0, 19, 4, 3, 26
"c:\Users\pa515\Downloads\wran-bulkProjectModified-main\wran-bulkProjectModified-main\src\icons\Path5\index.js", "JavaScript", 0, 1, 0, 0, 1, 2
"c:\Users\pa515\Downloads\wran-bulkProjectModified-main\wran-bulkProjectModified-main\src\icons\Path690\Path690.jsx", "JavaScript JSX", 0, 0, 19, 4, 3, 26
"c:\Users\pa515\Downloads\wran-bulkProjectModified-main\wran-bulkProjectModified-main\src\icons\Path690\index.js", "JavaScript", 0, 1, 0, 0, 1, 2
"c:\Users\pa515\Downloads\wran-bulkProjectModified-main\wran-bulkProjectModified-main\src\icons\Path6\Path6.jsx", "JavaScript JSX", 0, 0, 19, 4, 3, 26
"c:\Users\pa515\Downloads\wran-bulkProjectModified-main\wran-bulkProjectModified-main\src\icons\Path6\index.js", "JavaScript", 0, 1, 0, 0, 1, 2
"c:\Users\pa515\Downloads\wran-bulkProjectModified-main\wran-bulkProjectModified-main\src\icons\Shape1019\Shape1019.jsx", "JavaScript JSX", 0, 0, 21, 4, 3, 28
"c:\Users\pa515\Downloads\wran-bulkProjectModified-main\wran-bulkProjectModified-main\src\icons\Shape1019\index.js", "JavaScript", 0, 1, 0, 0, 1, 2
"c:\Users\pa515\Downloads\wran-bulkProjectModified-main\wran-bulkProjectModified-main\src\icons\Shape19\Shape19.jsx", "JavaScript JSX", 0, 0, 21, 4, 3, 28
"c:\Users\pa515\Downloads\wran-bulkProjectModified-main\wran-bulkProjectModified-main\src\icons\Shape19\index.js", "JavaScript", 0, 1, 0, 0, 1, 2
"c:\Users\pa515\Downloads\wran-bulkProjectModified-main\wran-bulkProjectModified-main\src\icons\Shape2\Shape2.jsx", "JavaScript JSX", 0, 0, 21, 4, 3, 28
"c:\Users\pa515\Downloads\wran-bulkProjectModified-main\wran-bulkProjectModified-main\src\icons\Shape2\index.js", "JavaScript", 0, 1, 0, 0, 1, 2
"c:\Users\pa515\Downloads\wran-bulkProjectModified-main\wran-bulkProjectModified-main\src\icons\Shape365\Shape365.jsx", "JavaScript JSX", 0, 0, 21, 4, 3, 28
"c:\Users\pa515\Downloads\wran-bulkProjectModified-main\wran-bulkProjectModified-main\src\icons\Shape365\index.js", "JavaScript", 0, 1, 0, 0, 1, 2
"c:\Users\pa515\Downloads\wran-bulkProjectModified-main\wran-bulkProjectModified-main\src\icons\Shape561\Shape561.jsx", "JavaScript JSX", 0, 0, 21, 4, 3, 28
"c:\Users\pa515\Downloads\wran-bulkProjectModified-main\wran-bulkProjectModified-main\src\icons\Shape561\index.js", "JavaScript", 0, 1, 0, 0, 1, 2
"c:\Users\pa515\Downloads\wran-bulkProjectModified-main\wran-bulkProjectModified-main\src\icons\Shape578\Shape578.jsx", "JavaScript JSX", 0, 0, 21, 4, 3, 28
"c:\Users\pa515\Downloads\wran-bulkProjectModified-main\wran-bulkProjectModified-main\src\icons\Shape578\index.js", "JavaScript", 0, 1, 0, 0, 1, 2
"c:\Users\pa515\Downloads\wran-bulkProjectModified-main\wran-bulkProjectModified-main\src\icons\Shape830\Shape830.jsx", "JavaScript JSX", 0, 0, 21, 4, 3, 28
"c:\Users\pa515\Downloads\wran-bulkProjectModified-main\wran-bulkProjectModified-main\src\icons\Shape830\index.js", "JavaScript", 0, 1, 0, 0, 1, 2
"c:\Users\pa515\Downloads\wran-bulkProjectModified-main\wran-bulkProjectModified-main\src\icons\Shape99\Shape99.jsx", "JavaScript JSX", 0, 0, 21, 4, 3, 28
"c:\Users\pa515\Downloads\wran-bulkProjectModified-main\wran-bulkProjectModified-main\src\icons\Shape99\index.js", "JavaScript", 0, 1, 0, 0, 1, 2
"c:\Users\pa515\Downloads\wran-bulkProjectModified-main\wran-bulkProjectModified-main\src\icons\StepActionsBgFocusCopy16\StepActionsBgFocusCopy16.jsx", "JavaScript JSX", 0, 0, 23, 4, 3, 30
"c:\Users\pa515\Downloads\wran-bulkProjectModified-main\wran-bulkProjectModified-main\src\icons\StepActionsBgFocusCopy16\index.js", "JavaScript", 0, 1, 0, 0, 1, 2
"c:\Users\pa515\Downloads\wran-bulkProjectModified-main\wran-bulkProjectModified-main\src\icons\TabItemBar23\TabItemBar23.jsx", "JavaScript JSX", 0, 0, 13, 4, 3, 20
"c:\Users\pa515\Downloads\wran-bulkProjectModified-main\wran-bulkProjectModified-main\src\icons\TabItemBar23\index.js", "JavaScript", 0, 1, 0, 0, 1, 2
"c:\Users\pa515\Downloads\wran-bulkProjectModified-main\wran-bulkProjectModified-main\src\icons\Vector10\Vector10.jsx", "JavaScript JSX", 0, 0, 60, 4, 3, 67
"c:\Users\pa515\Downloads\wran-bulkProjectModified-main\wran-bulkProjectModified-main\src\icons\Vector10\index.js", "JavaScript", 0, 1, 0, 0, 1, 2
"c:\Users\pa515\Downloads\wran-bulkProjectModified-main\wran-bulkProjectModified-main\src\icons\Vector11\Vector11.jsx", "JavaScript JSX", 0, 0, 21, 4, 3, 28
"c:\Users\pa515\Downloads\wran-bulkProjectModified-main\wran-bulkProjectModified-main\src\icons\Vector11\index.js", "JavaScript", 0, 1, 0, 0, 1, 2
"c:\Users\pa515\Downloads\wran-bulkProjectModified-main\wran-bulkProjectModified-main\src\icons\Vector6\Vector6.jsx", "JavaScript JSX", 0, 0, 60, 4, 3, 67
"c:\Users\pa515\Downloads\wran-bulkProjectModified-main\wran-bulkProjectModified-main\src\icons\Vector6\index.js", "JavaScript", 0, 1, 0, 0, 1, 2
"c:\Users\pa515\Downloads\wran-bulkProjectModified-main\wran-bulkProjectModified-main\src\icons\Vector7\Vector7.jsx", "JavaScript JSX", 0, 0, 60, 4, 3, 67
"c:\Users\pa515\Downloads\wran-bulkProjectModified-main\wran-bulkProjectModified-main\src\icons\Vector7\index.js", "JavaScript", 0, 1, 0, 0, 1, 2
"c:\Users\pa515\Downloads\wran-bulkProjectModified-main\wran-bulkProjectModified-main\src\icons\Vector8\Vector8.jsx", "JavaScript JSX", 0, 0, 60, 4, 3, 67
"c:\Users\pa515\Downloads\wran-bulkProjectModified-main\wran-bulkProjectModified-main\src\icons\Vector8\index.js", "JavaScript", 0, 1, 0, 0, 1, 2
"c:\Users\pa515\Downloads\wran-bulkProjectModified-main\wran-bulkProjectModified-main\src\icons\Vector9\Vector9.jsx", "JavaScript JSX", 0, 0, 60, 4, 3, 67
"c:\Users\pa515\Downloads\wran-bulkProjectModified-main\wran-bulkProjectModified-main\src\icons\Vector9\index.js", "JavaScript", 0, 1, 0, 0, 1, 2
"c:\Users\pa515\Downloads\wran-bulkProjectModified-main\wran-bulkProjectModified-main\src\index.jsx", "JavaScript JSX", 0, 0, 6, 0, 3, 9
"c:\Users\pa515\Downloads\wran-bulkProjectModified-main\wran-bulkProjectModified-main\src\screens\CbpmScreen\CbpmScreen.jsx", "JavaScript JSX", 0, 0, 448, 0, 4, 452
"c:\Users\pa515\Downloads\wran-bulkProjectModified-main\wran-bulkProjectModified-main\src\screens\CbpmScreen\index.js", "JavaScript", 0, 1, 0, 0, 1, 2
"c:\Users\pa515\Downloads\wran-bulkProjectModified-main\wran-bulkProjectModified-main\src\screens\CbpmScreen\style.css", "CSS", 1186, 0, 0, 0, 134, 1320
"c:\Users\pa515\Downloads\wran-bulkProjectModified-main\wran-bulkProjectModified-main\src\screens\Cbpm\Cbpm.jsx", "JavaScript JSX", 0, 0, 83, 0, 5, 88
"c:\Users\pa515\Downloads\wran-bulkProjectModified-main\wran-bulkProjectModified-main\src\screens\Cbpm\index.js", "JavaScript", 0, 1, 0, 0, 1, 2
"c:\Users\pa515\Downloads\wran-bulkProjectModified-main\wran-bulkProjectModified-main\src\screens\Cbpm\style.css", "CSS", 133, 0, 0, 1, 25, 159
"c:\Users\pa515\Downloads\wran-bulkProjectModified-main\wran-bulkProjectModified-main\src\screens\DivWrapper\DivWrapper.jsx", "JavaScript JSX", 0, 0, 403, 0, 2, 405
"c:\Users\pa515\Downloads\wran-bulkProjectModified-main\wran-bulkProjectModified-main\src\screens\DivWrapper\index.js", "JavaScript", 0, 1, 0, 0, 1, 2
"c:\Users\pa515\Downloads\wran-bulkProjectModified-main\wran-bulkProjectModified-main\src\screens\DivWrapper\style.css", "CSS", 973, 0, 0, 0, 111, 1084
"c:\Users\pa515\Downloads\wran-bulkProjectModified-main\wran-bulkProjectModified-main\src\screens\Screen10\Screen10.jsx", "JavaScript JSX", 0, 0, 892, 0, 3, 895
"c:\Users\pa515\Downloads\wran-bulkProjectModified-main\wran-bulkProjectModified-main\src\screens\Screen10\index.js", "JavaScript", 0, 1, 0, 0, 1, 2
"c:\Users\pa515\Downloads\wran-bulkProjectModified-main\wran-bulkProjectModified-main\src\screens\Screen10\style.css", "CSS", 1385, 0, 0, 1, 155, 1541
"c:\Users\pa515\Downloads\wran-bulkProjectModified-main\wran-bulkProjectModified-main\src\screens\Screen11\Screen11.jsx", "JavaScript JSX", 0, 0, 1247, 0, 3, 1250
"c:\Users\pa515\Downloads\wran-bulkProjectModified-main\wran-bulkProjectModified-main\src\screens\Screen11\index.js", "JavaScript", 0, 1, 0, 0, 1, 2
"c:\Users\pa515\Downloads\wran-bulkProjectModified-main\wran-bulkProjectModified-main\src\screens\Screen11\style.css", "CSS", 1487, 0, 0, 1, 164, 1652
"c:\Users\pa515\Downloads\wran-bulkProjectModified-main\wran-bulkProjectModified-main\src\screens\Screen12\Screen12.jsx", "JavaScript JSX", 0, 0, 1247, 0, 5, 1252
"c:\Users\pa515\Downloads\wran-bulkProjectModified-main\wran-bulkProjectModified-main\src\screens\Screen12\index.js", "JavaScript", 0, 1, 0, 0, 1, 2
"c:\Users\pa515\Downloads\wran-bulkProjectModified-main\wran-bulkProjectModified-main\src\screens\Screen12\style.css", "CSS", 1487, 0, 0, 1, 164, 1652
"c:\Users\pa515\Downloads\wran-bulkProjectModified-main\wran-bulkProjectModified-main\src\screens\Screen13\Screen13.jsx", "JavaScript JSX", 0, 0, 1014, 0, 3, 1017
"c:\Users\pa515\Downloads\wran-bulkProjectModified-main\wran-bulkProjectModified-main\src\screens\Screen13\index.js", "JavaScript", 0, 1, 0, 0, 1, 2
"c:\Users\pa515\Downloads\wran-bulkProjectModified-main\wran-bulkProjectModified-main\src\screens\Screen13\style.css", "CSS", 1499, 0, 0, 1, 168, 1668
"c:\Users\pa515\Downloads\wran-bulkProjectModified-main\wran-bulkProjectModified-main\src\screens\Screen14\Screen14.jsx", "JavaScript JSX", 0, 0, 1006, 0, 5, 1011
"c:\Users\pa515\Downloads\wran-bulkProjectModified-main\wran-bulkProjectModified-main\src\screens\Screen14\index.js", "JavaScript", 0, 1, 0, 0, 1, 2
"c:\Users\pa515\Downloads\wran-bulkProjectModified-main\wran-bulkProjectModified-main\src\screens\Screen14\style.css", "CSS", 1516, 0, 0, 1, 170, 1687
"c:\Users\pa515\Downloads\wran-bulkProjectModified-main\wran-bulkProjectModified-main\src\screens\Screen15\Screen15.jsx", "JavaScript JSX", 0, 0, 996, 1, 5, 1002
"c:\Users\pa515\Downloads\wran-bulkProjectModified-main\wran-bulkProjectModified-main\src\screens\Screen15\index.js", "JavaScript", 0, 1, 0, 0, 1, 2
"c:\Users\pa515\Downloads\wran-bulkProjectModified-main\wran-bulkProjectModified-main\src\screens\Screen15\style.css", "CSS", 1489, 0, 0, 1, 167, 1657
"c:\Users\pa515\Downloads\wran-bulkProjectModified-main\wran-bulkProjectModified-main\src\screens\Screen3\Screen3.jsx", "JavaScript JSX", 0, 0, 1202, 0, 3, 1205
"c:\Users\pa515\Downloads\wran-bulkProjectModified-main\wran-bulkProjectModified-main\src\screens\Screen3\index.js", "JavaScript", 0, 1, 0, 0, 1, 2
"c:\Users\pa515\Downloads\wran-bulkProjectModified-main\wran-bulkProjectModified-main\src\screens\Screen3\style.css", "CSS", 2954, 0, 0, 0, 259, 3213
"c:\Users\pa515\Downloads\wran-bulkProjectModified-main\wran-bulkProjectModified-main\src\screens\Screen4\Screen4.jsx", "JavaScript JSX", 0, 0, 288, 0, 2, 290
"c:\Users\pa515\Downloads\wran-bulkProjectModified-main\wran-bulkProjectModified-main\src\screens\Screen4\index.js", "JavaScript", 0, 1, 0, 0, 1, 2
"c:\Users\pa515\Downloads\wran-bulkProjectModified-main\wran-bulkProjectModified-main\src\screens\Screen4\style.css", "CSS", 1012, 0, 0, 0, 118, 1130
"c:\Users\pa515\Downloads\wran-bulkProjectModified-main\wran-bulkProjectModified-main\src\screens\Screen5\Screen5.jsx", "JavaScript JSX", 0, 0, 111, 0, 2, 113
"c:\Users\pa515\Downloads\wran-bulkProjectModified-main\wran-bulkProjectModified-main\src\screens\Screen5\index.js", "JavaScript", 0, 1, 0, 0, 1, 2
"c:\Users\pa515\Downloads\wran-bulkProjectModified-main\wran-bulkProjectModified-main\src\screens\Screen5\style.css", "CSS", 412, 0, 0, 0, 49, 461
"c:\Users\pa515\Downloads\wran-bulkProjectModified-main\wran-bulkProjectModified-main\src\screens\Screen6\Screen6.jsx", "JavaScript JSX", 0, 0, 113, 0, 2, 115
"c:\Users\pa515\Downloads\wran-bulkProjectModified-main\wran-bulkProjectModified-main\src\screens\Screen6\index.js", "JavaScript", 0, 1, 0, 0, 1, 2
"c:\Users\pa515\Downloads\wran-bulkProjectModified-main\wran-bulkProjectModified-main\src\screens\Screen6\style.css", "CSS", 298, 0, 0, 0, 34, 332
"c:\Users\pa515\Downloads\wran-bulkProjectModified-main\wran-bulkProjectModified-main\src\screens\Screen7\Screen7.jsx", "JavaScript JSX", 0, 0, 228, 0, 2, 230
"c:\Users\pa515\Downloads\wran-bulkProjectModified-main\wran-bulkProjectModified-main\src\screens\Screen7\index.js", "JavaScript", 0, 1, 0, 0, 1, 2
"c:\Users\pa515\Downloads\wran-bulkProjectModified-main\wran-bulkProjectModified-main\src\screens\Screen7\style.css", "CSS", 720, 0, 0, 0, 88, 808
"c:\Users\pa515\Downloads\wran-bulkProjectModified-main\wran-bulkProjectModified-main\src\screens\Screen8\Screen8.jsx", "JavaScript JSX", 0, 0, 286, 0, 2, 288
"c:\Users\pa515\Downloads\wran-bulkProjectModified-main\wran-bulkProjectModified-main\src\screens\Screen8\index.js", "JavaScript", 0, 1, 0, 0, 1, 2
"c:\Users\pa515\Downloads\wran-bulkProjectModified-main\wran-bulkProjectModified-main\src\screens\Screen8\style.css", "CSS", 1004, 0, 0, 0, 117, 1121
"c:\Users\pa515\Downloads\wran-bulkProjectModified-main\wran-bulkProjectModified-main\src\screens\Screen9\Screen9.jsx", "JavaScript JSX", 0, 0, 293, 0, 2, 295
"c:\Users\pa515\Downloads\wran-bulkProjectModified-main\wran-bulkProjectModified-main\src\screens\Screen9\index.js", "JavaScript", 0, 1, 0, 0, 1, 2
"c:\Users\pa515\Downloads\wran-bulkProjectModified-main\wran-bulkProjectModified-main\src\screens\Screen9\style.css", "CSS", 1015, 0, 0, 0, 120, 1135
"Total", "-", 19756, 336, 13011, 416, 2735, 36254